NO ./sprites/N.xpm

SO ./sprites/S.xpm


WE ./sprites/O.xpm




EA ./sprites/E.xpm

F      120,120,120
C      025,36,255






1111111111111111111111111111111111
100000000000000000000000000000011
100S000000000000000000000000000011
10000000000000000000000000000000011
10000000000000000000000000000000011
1000000000000000000000000000000001
1000001111111111111111111110000001
1000001                   10000001
1000001                    10000001
1000001                     10000001
1000001                      1000001
1000001                      1000001
1000001                       1000001
1000001                       1000001
1000001                       1000001
1000001                       1000001
1000001                       1000001
1000001                       1000001
1000001                       1000001
1000001                       1000001
1000001                       1000001
1000001                      1000001
1000001                      1000001
 1000001                     11000001
  1000001                   10000011
   1000001111111111111111111000001
    10000000000000000000000000001
    11100000000000000000000000001
    1110000000000000000000000001
    11100000000000000000000000001
       1100000000000000000000001
         11111111111111111111111