
NO ./sprites/NORD.xpm 



SO ./sprites/SUD.xpm

EA ./sprites/EST.xpm






F      125,36,255

WE ./sprites/OUEST.xpm

1111111111111
10000000W0001
1001111111001
1001     1001
1001111111001
1000000000001
1111111111111