
NO ./sprites/NORD.xpm 



SO ./sprites/SUD.xpm

EA ./sprites/EST.xpm

WE ./sprites/OUEST.xpm





F      125,36,255
C      025,036,205












111111111111111111111111111111111111111111111111111111111111111111
11111111111111111111111111111111111111111111111111N111111111111111
1111111111111111111111111111111111111111111111111111111111111111111111